voiture	False	accueil_voiture-R
Pourquoi	True	None
je	True	None
aliments	False	accueil_aliments-R
école	False	Accueil_école-R
maman	False	None
fleur	False	Accueil_fleur-R
quoi	True	None
exemple	False	None
quoi	True	None
il	False	None
je	True	None
c'est	False	None
maman	True	None
voiture	False	accueil_voiture-R
page1	False	accueil_page1-R
non	True	None
oui	True	None
on	False	None
y	False	None
va	False	None
plus	False	None
loin	False	None
loi	False	None
mdr	True	None
arriver	False	None
neuf	False	None
oeuf	False	None
sarah	False	None
Lyon	False	None
lion	False	None
chèvre	False	None
parc	False	None
ordinateur	True	None
tablette	False	None
téléphone	False	None
télévision	False	None
voiture	False	None
machine-à-laver	False	None
lave-vaisselle	False	None
paris	False	None
marseille	False	None
New-york	False	None
entité	False	None
nommée	False	None
TAL	True	None
étude	False	None
Université	False	accueil_Université-R
parcours	False	None
travail	False	None
loin False	None
loin	False	None
loin	False	None
loin	False	None
loin	False	None
loin	False	None
fenêtre	False	None
porte	False	None
maison	False	None
bois	False	None
eau	False	None
exemple	False	None
anglais	False	None
italien	False	None
Pays	False	accueil_Pays-R
ville	False	accueil_ville-R
légume	False	accueil_légume-R